      ________
     |       E|
     |  ______|
     |  |  |  |
     |  |  |  |
     |        |
     |  ___   |
     |  |     |
     |__|  ___|
     |     |  |
     |  ___|  |
     |     |  |
     |  ___|  |
     |        |
     |__      |
     |  |  |  |
     |  |__|  |
     |  |  |  |
     |  |  |  |
     |  |     |
     |  |__   |
     |     |  |
     |     |  |
     |  |     |
     |__|__   |
     |        |
     |__   ___|
     |        |
     |_____   |
     |     |  |
     |  ___|  |
     |        |
     |__   ___|
     |     |  |
     |  ___|  |
     |     |  |
     |  ___|  |
     |     |  |
     |__   |  |
     |  |     |
     |  |__   |
     |     |  |
     |__   |  |
     |  |     |
     |  |__   |
     |        |
     |  ______|
     |        |
     |  ___   |
     |     |  |
     |__   |__|
     |  |     |
     |  |__   |
     |        |
     |        |
     |  |  |  |
     |  |__|  |
     |     |  |
     |     |__|
     |  |     |
     |__|     |
     |  |  |  |
     |  |__|  |
     |        |
     |  ___   |
     |  |     |
     |  |__   |
     |  |  |  |
     |__|  |  |
     |  |     |
     |  |  ___|
     |        |
     |  ______|
     |     |  |
     |     |  |
     |  |     |
     |__|__   |
     |        |
     |__   ___|
     |  |     |
     |  |  ___|
     |     |  |
     |  ___|  |
     |  |     |
     |  |  ___|
     |  |     |
     |  |__   |
     |  |     |
     |  |__   |
     |     |  |
     |     |  |
     |  |     |
     |  |  ___|
     |  |     |
     |  |_____|
     |  |     |
     |  |__   |
     |        |
     |_____   |
     |  |     |
     |  |__   |
     |        |
     |__   ___|
     |     |  |
     |__   |  |
     |        |
     |_____   |
     |     |  |
     |  ___|  |
     |     |  |
     |__   |  |
     |        |
     |_____   |
     |        |
     |     ___|
     |  |     |
     |__|__   |
     |     |  |
     |     |  |
     |  |     |
     |__|     |
     |     |  |
     |     |__|
     |  |  |  |
     |  |  |  |
     |  |     |
     |__|__   |
     |  |     |
     |  |  ___|
     |        |
     |__   ___|
     |  |     |
     |  |  ___|
     |        |
     |__      |
     |     |  |
     |  ___|  |
     |  |  |  |
     |  |  |__|
     |        |
     |        |
     |  |  |  |
     |__|__|  |
     |        |
     |     ___|
     |  |     |
     |  |  ___|
     |  |     |
     |__|__   |
     |     |  |
     |     |  |
     |  |     |
     |__|  ___|
     |  |  |  |
     |  |  |  |
     |  |  |  |
     |  |  |  |
     |        |
     |  ______|
     |  |     |
     |  |     |
     |  |  |  |
     |  |__|  |
     |        |
     |__   ___|
     |        |
     |_____   |
     |        |
     |  ___   |
     |     |  |
     |  ___|__|
     |        |
     |_____   |
     |     |  |
     |  ___|  |
     |  |     |
     |  |__   |
     |        |
     |_____   |
     |     |  |
     |__   |  |
     |        |
     |     ___|
     |  |  |  |
     |__|  |  |
     |     |  |
     |     |  |
     |  |     |
     |  |__   |
     |     |  |
     |__   |__|
     |     |  |
     |  ___|  |
     |  |     |
     |  |     |
     |     |  |
     |__   |__|
     |        |
     |  ___   |
     |S |     |
     |__|_____|
